— 150 —

Bonod0apckome: Сквирку, Пархомовку и JIOXBAAKYy.
Погребищскомз: Овсянецкую Kopumy, Сопинъ и Вулень.
Фастовскомё: Снитинку Великую и Снфгировъ.
Германовском: Ольшаную.
Червонскоме: Кириловку.
_ Доденскомв: Грушку и Вертиюевку.
Ловковскомз: Иванковъ.
JTpoanoeckonż: Головинъ, не имфющее вовсе арендатора.
Коростышовскоме: Розважевку, Микулевичи и Косарищи.
_ Радомысльскоме: Паперию, Заблоцкую Lyry и Врым-
скую Рудню.
Черньховскоме: Byka И Новую Рудню.
_Лугинском: Михайловку, Колки, Вондаревку, Погор*-
лую и Купищу.
Веледницкомз: МедвЪдну..
Овуучскоме: Камень.
Народичскомг: Закусилы, Лотоши,  Дашки И Жеревъ.
Хабенскомь: Залисяны и Левковичи.
Хойницком5: Корчеву, Ржешовцы, Рудню и Щербины.
Бразинскомв — Лиштвинъ, Вылитинъ, Евласы, Дублинъ
и Галки.
Чериобылеькомь: Семигоды и Рудень.
Горновтайтольскоме: Лопутки.
Иванковскоме: Таль (рудню).
Бородянском: Димидовъ и Литвиновку.
Ясногородскоме — Горемичи.
БВрусиловскомь — Хомянку.
Ходорковском8 — Рубеку.
Миропольскомг — Марляновскую елободку. |
Чудновскомг—Стрибичъ, Гуту, Буду, Колки. и Шенявку.
[l amxoecnone —Талтариновскую Корчму ‘и
Любарскомг: Кирлевскую Корчму, Березовскую Корчиу
и Семеновку. | ; |
